00000001
00000000
00000000
00010000
00000000
00000200
00000010
00000000