02020202
20202020
02020202
00000000
00000000
10101010
01010101
10101010