00000000
03000000
00000000
00020000
00002000
00000000
00000020
00000000